1111111111111
1P010000C00C1
100P011111001
100011E000001
1111111111111
