111111111111111111111111111111111111111111111
1P10000000000000000000000000000000000000000C1
111011111110000000000000C00000000000000000001
100000000010000000000000000000000000000000001
100000000000C00000000000000000C00000000000001
10000000000000000000000000000000000E000000001
111111111111111111111111111111111111111111111
